1111111111111111
1000000000000001
1011111111111101
1010000000001001
1010111111101101
1000100000101001
1010101110101101
1010001010101001
1010111011101101
1010000010001001
1010111111101101
1000000000000001
1011111111111101
1000000000000001
1000000011000001
1111111111111111